date,doses,doses_first,doses_second,pfizer_cumul,moderna_cumul,astrazeneca_cumul,persons_first_cumul,persons_full_cumul
2020-12-27,24429,24429,0,24420,8,1,24429,0
2020-12-28,18007,18007,0,42425,9,2,42436,0
2020-12-29,50065,50065,0,92489,9,3,92501,0
2020-12-30,64088,64088,0,156576,10,3,156589,0
2020-12-31,49939,49939,0,206513,12,3,206528,0
2021-01-01,25672,25672,0,232164,27,7,232200,0
2021-01-02,47804,47804,0,279965,28,7,280004,0
2021-01-03,22573,22573,0,302531,35,7,302577,0
2021-01-04,46362,46362,0,348863,46,8,348939,0
2021-01-05,52484,52484,0,401343,50,8,401423,0
2021-01-06,63097,63097,0,464431,57,10,464520,0
2021-01-07,54908,54908,0,519327,65,13,519428,0
2021-01-08,62875,62875,0,582146,118,16,582303,0
2021-01-09,60598,60598,0,642736,126,16,642901,0
2021-01-10,35845,35845,0,678569,136,17,678746,0
2021-01-11,68776,68776,0,747332,146,20,747522,0
2021-01-12,79322,79322,0,826629,167,23,826844,0
2021-01-13,112451,112451,0,937897,1350,23,939295,0
2021-01-14,84132,84132,0,1016905,6472,25,1023427,0
2021-01-15,91864,90881,983,1103462,11758,44,1114308,983
2021-01-16,58099,56855,1244,1159865,13452,45,1171163,2227
2021-01-17,47842,30757,17085,1206440,14717,46,1201920,19312
2021-01-18,83329,67569,15760,1285503,18980,49,1269489,35072
2021-01-19,119890,83806,36084,1401573,22749,100,1353295,71156
2021-01-20,132972,79002,53970,1531697,25593,104,1432297,125126
2021-01-21,105651,64534,41117,1634517,28419,108,1496831,166243
2021-01-22,102416,68788,33628,1734722,30616,122,1565619,199871
2021-01-23,87092,40772,46320,1821448,30977,127,1606391,246191
2021-01-24,47836,25706,22130,1869075,31181,131,1632097,268321
2021-01-25,91078,52347,38731,1958695,32636,134,1684444,307052
2021-01-26,98705,51357,47348,2055950,34079,141,1735801,354400
2021-01-27,109656,51184,58472,2163802,35873,149,1786985,412872
2021-01-28,92764,47015,45749,2254927,37508,153,1834000,458621
2021-01-29,107829,49886,57943,2361197,38995,224,1883886,516564
2021-01-30,88164,34670,53494,2448471,39879,228,1918556,570058
2021-01-31,57243,25808,31435,2505323,40264,233,1944364,601493
2021-02-01,120501,58397,62104,2623543,42488,289,2002761,663597
2021-02-02,132894,65533,67361,2753270,45628,314,2068294,730958
2021-02-03,163129,64632,98497,2909969,52030,341,2132926,829455
2021-02-04,134693,62158,72535,3038752,57932,349,2195084,901990
2021-02-05,147586,69419,78167,3179851,64409,358,2264503,980157
2021-02-06,94199,45606,48593,3271409,67048,359,2310109,1028750
2021-02-07,53580,28305,25275,3322643,69390,362,2338414,1054025
2021-02-08,109526,53034,56492,3428296,73232,392,2391448,1110517
2021-02-09,134776,60267,74509,3559437,76680,579,2451715,1185026
2021-02-10,155578,77799,77779,3702315,80980,8978,2529514,1262805
2021-02-11,144756,75689,69067,3823230,88301,25496,2605203,1331872
2021-02-12,156321,80307,76014,3955739,97686,39917,2685510,1407886
2021-02-13,107893,62063,45830,4046941,100961,53332,2747573,1453716
2021-02-14,65481,39643,25838,4102633,103446,60635,2787216,1479554
2021-02-15,125962,70182,55780,4207708,108772,76184,2857398,1535334
2021-02-16,134985,78292,56693,4316756,114990,95902,2935690,1592027
2021-02-17,151958,95449,56509,4439661,123059,116882,3031139,1648536
2021-02-18,145277,91876,53401,4552595,131353,140925,3123015,1701937
2021-02-19,158987,103164,55823,4673874,141400,168585,3226179,1757760
2021-02-20,112569,76202,36367,4760595,145885,189942,3302381,1794127
2021-02-21,86061,57733,28328,4827190,149536,205754,3360114,1822455
2021-02-22,156709,98337,58372,4950803,158615,229770,3458451,1880827
2021-02-23,170657,110051,60606,5085169,165983,258691,3568502,1941433
2021-02-24,177241,117717,59524,5217411,173648,296024,3686219,2000957
2021-02-25,190477,130992,59485,5349524,180444,347592,3817211,2060442
2021-02-26,214313,146601,67712,5491537,189333,411003,3963812,2128154
2021-02-27,148396,108533,39863,5584376,193426,462464,4072345,2168017
2021-02-28,103640,79436,24204,5646041,197409,500454,4151781,2192221
2021-03-01,199418,149457,49961,5777099,207129,559094,4301238,2242182
2021-03-02,220256,167981,52275,5918067,217240,628271,4469219,2294457
2021-03-03,248686,177797,70889,6076781,232430,703052,4647016,2365346
2021-03-04,245790,182593,63197,6218576,246968,792509,4829609,2428543
2021-03-05,276076,208561,67515,6367266,260387,906474,5038170,2496058
2021-03-06,203019,154264,48755,6476834,269256,991056,5192434,2544813
2021-03-07,147942,114389,33553,6556747,275947,1052394,5306823,2578366
2021-03-08,238656,186704,51952,6691425,286944,1145374,5493527,2630318
2021-03-09,253281,198274,55007,6832110,299760,1245154,5691801,2685325
2021-03-10,289634,222131,67503,6991430,312022,1363205,5913932,2752828
2021-03-11,284946,223956,60990,7138900,325831,1486872,6137888,2813818
2021-03-12,328726,257559,71167,7290902,343245,1646181,6395447,2884985
2021-03-13,241709,191302,50407,7407197,352867,1761973,6586749,2935392
2021-03-14,170548,134840,35708,7495486,358390,1838709,6721589,2971100
2021-03-15,249661,190319,59342,7648812,371260,1922174,6911908,3030442
2021-03-16,179633,111224,68409,7815917,382579,1923383,7023132,3098851
2021-03-17,206129,124891,81238,8003156,400651,1924200,7148023,3180089
2021-03-18,194372,118485,75887,8177877,418901,1925601,7266508,3255976
2021-03-19,246303,161605,84698,8364092,439831,1964759,7428113,3340674
2021-03-20,221478,168050,53428,8500091,455192,2034877,7596163,3394102
2021-03-21,165066,126724,38342,8602600,464406,2088219,7722887,3432444
2021-03-22,270039,193277,76762,8769167,488406,2167691,7916164,3509206
2021-03-23,299344,214915,84429,8947974,508425,2268207,8131079,3593635
2021-03-24,339687,250103,89584,9146169,541836,2376285,8381182,3683219
2021-03-25,332966,251625,81341,9330632,569690,2496933,8632807,3764560
2021-03-26,374810,285763,89047,9530282,607118,2634663,8918570,3853607
2021-03-27,282563,219984,62579,9680331,634841,2739451,9138554,3916186
2021-03-28,196852,143500,53352,9795929,653408,2802135,9282054,3969538
2021-03-29,305693,216693,89000,9984763,678591,2893810,9498747,4058538
2021-03-30,326269,233776,92493,10199972,703186,2980274,9732523,4151031
2021-03-31,334306,232666,101640,10445893,739709,3032135,9965189,4252671
2021-04-01,332434,241495,90939,10686359,772392,3091400,10206684,4343629
2021-04-02,226467,158467,68000,10866273,786869,3123471,10365151,4411634
2021-04-03,232511,167810,64701,11040486,802792,3165846,10532961,4476335
2021-04-04,193524,142948,50576,11173122,812900,3216623,10675909,4526911
2021-04-05,248537,178087,70450,11338732,830793,3281657,10853996,4597361
2021-04-06,392431,297773,94658,11610846,863072,3369679,11151769,4692033
2021-04-07,725726,629364,96362,12209635,900466,3459205,11781133,4788411
2021-04-08,718305,631259,87046,12799769,936336,3551491,12412392,4875469
2021-04-09,621556,532563,88993,13278830,973170,3657145,12944955,4964467
2021-04-10,369340,304037,65303,13523158,996429,3758897,13248992,5029770
2021-04-11,261039,210585,50454,13691012,1015124,3833386,13459577,5080224
2021-04-12,412065,335256,76809,13961429,1044583,3945558,13794833,5157048
2021-04-13,603725,529744,73981,14420370,1071992,4062923,14324577,5231039
2021-04-14,808179,724290,83889,15069816,1105837,4187791,15048867,5314948
2021-04-15,682285,611554,70731,15606534,1142300,4296870,15660421,5385703
2021-04-16,582540,507903,74637,16030128,1175028,4423079,16168324,5460348
2021-04-17,359060,302378,56682,16248203,1197778,4541314,16470702,5517030
2021-04-18,267084,227943,39141,16417431,1213210,4623737,16698645,5556171
2021-04-19,398285,336245,62040,16704989,1246624,4701037,17034890,5618224
2021-04-20,589034,525428,63606,17103932,1286202,4851530,17560318,5681847
2021-04-21,749191,674969,74222,17574626,1328529,5087675,18235287,5756094
2021-04-22,639313,571258,68055,17955229,1373146,5301733,18806545,5824184
2021-04-23,541432,471677,69755,18300575,1417051,5453896,19278222,5893947
2021-04-24,362415,303173,59242,18533454,1466633,5533846,19581395,5953189
2021-04-25,280041,230712,49329,18720240,1500340,5593390,19812107,6002518
2021-04-26,436305,361579,74726,19046447,1542911,5660819,20173686,6077264
2021-04-27,859090,764472,94618,19800094,1594609,5713988,20938158,6171899
2021-04-28,1162379,1029442,132937,20850767,1655479,5764008,21967600,6304862
2021-04-29,946102,809011,137091,21676268,1719251,5819937,22776611,6441974
2021-04-30,766442,629093,137349,22319940,1776658,5884371,23405704,6579343
2021-05-01,323708,250507,73201,22559873,1818228,5923943,23656211,6652544
2021-05-02,258734,193577,65157,22749377,1855709,5953881,23849788,6717706
2021-05-03,454303,338117,116186,23064467,1926499,6020604,24187905,6833907
2021-05-04,897799,734104,163695,23734498,1989864,6181907,24922009,6997634
2021-05-05,1210617,972256,238361,24635530,2069264,6407489,25894265,7236013
2021-05-06,1001331,777818,223513,25332286,2162041,6614603,26672083,7459575
2021-05-07,857658,624105,233553,25889984,2248982,6823041,27296188,7693204
2021-05-08,412866,261100,151766,26147012,2321081,6905073,27557288,7844970
2021-05-09,280596,179427,101169,26337806,2377609,6937270,27736715,7946148
2021-05-10,603632,411467,192165,26717930,2459606,7074430,28148182,8138422
2021-05-11,1166940,867863,299077,27618944,2540333,7255799,29016045,8437545
2021-05-12,1469247,1095872,373374,28759463,2632739,7486300,30111917,8811001
2021-05-13,414025,259261,154764,29059390,2699723,7530732,30371178,8965773
2021-05-14,741117,518604,222513,29591220,2764794,7667103,30889782,9188331
2021-05-15,393687,234164,159523,29859883,2825746,7726878,31123946,9347863
2021-05-16,273950,158476,115474,30054446,2878353,7748917,31282422,9463343
2021-05-17,551722,352727,198995,30382013,2964412,7876973,31635149,9662429
2021-05-18,931875,558654,373221,31023508,3065716,8058114,32193803,10035757
2021-05-19,1189815,621824,567991,31899858,3166507,8258334,32815627,10603966
2021-05-20,984709,483276,501433,32609890,3263906,8424891,33298903,11105607
2021-05-21,843156,418927,424229,33189688,3350011,8590040,33717830,11530360
2021-05-22,396770,185773,210997,33438843,3418926,8654535,33903603,11741687
2021-05-23,271905,122732,149173,33627659,3478426,8669307,34026335,11890974
2021-05-24,315882,141864,174018,33858565,3540073,8684472,34168199,12065146
2021-05-25,686021,311755,374266,34328573,3619971,8791373,34479954,12459373
2021-05-26,1276284,595248,681036,35293612,3703155,8930349,35075202,13219809
2021-05-27,1056526,496682,559844,36040803,3792909,9063706,35571884,13856180
2021-05-28,887956,438936,449020,36627353,3879051,9192336,36010820,14380672
2021-05-29,406013,181787,224226,36878927,3941655,9254561,36192607,14623600
2021-05-30,273374,102504,170870,37069073,3988749,9281377,36295111,14797072
2021-05-31,581181,249335,331846,37449621,4056748,9362098,36544446,15174539
2021-06-01,1027886,500307,527329,38236477,4136652,9437531,37044753,15781329
2021-06-02,1317774,665881,651709,39284756,4209844,9518579,37710634,16540803
2021-06-03,641505,285705,355631,39757148,4274573,9568884,37996339,16943144
2021-06-04,800086,363658,436002,40329432,4345748,9646620,38359997,17452428
2021-06-05,412288,130336,281786,40592979,4412662,9690240,38490333,17764287
2021-06-06,272622,63269,209233,40786949,4453392,9715088,38553602,17978071
2021-06-07,610373,244997,365259,41181434,4538478,9791456,38798599,18394361
2021-06-08,1147693,442174,705360,42117892,4614008,9853983,39240773,19168817
2021-06-09,1508590,577746,930602,43374814,4701281,9918595,39818519,20190678
2021-06-10,1219353,512191,706879,44353032,4790809,9976793,40330710,20984574
2021-06-11,1036733,460080,576260,45133717,4880440,10045184,40790790,21649172
2021-06-12,433696,166924,266570,45410196,4953158,10090671,40957714,21947386
2021-06-13,261926,67556,194145,45573799,5016642,10114313,41025270,22147412
2021-06-14,641657,263863,377409,45985190,5118133,10186326,41289133,22577087
2021-06-15,1144049,445170,698608,46877413,5222589,10271549,41734303,23335109
2021-06-16,1441524,566707,874640,48035595,5328593,10370863,42301010,24282859
2021-06-17,1159209,480489,677942,48926592,5432411,10463504,42781499,25028744
2021-06-18,965031,410667,554174,49632281,5527211,10559297,43192166,25647453
2021-06-19,425095,147966,276993,49897251,5609750,10610558,43340132,25947879
2021-06-20,278580,72989,205507,50063044,5681058,10640938,43413121,26160060
2021-06-21,621975,238356,383490,50466045,5778858,10728172,43651477,26575211
2021-06-22,1161869,437519,724211,51392499,5874933,10834915,44088996,27327827
2021-06-23,1425233,562424,862684,52563918,5971438,10955300,44651420,28221555
2021-06-24,1036886,549391,487382,53357503,6058978,11069057,45200811,28744001
2021-06-25,898201,415096,482982,54032135,6135360,11175009,45615907,29258015
2021-06-26,410442,154711,255610,54281915,6204665,11249579,45770618,29525459
2021-06-27,278686,88337,190280,54442596,6262874,11305157,45858955,29718613
2021-06-28,618125,260309,357716,54832569,6352744,11419940,46119264,30095299
2021-06-29,1004524,443410,561013,55582355,6445280,11559459,46562674,30674398
2021-06-30,1128362,521500,606773,56452146,6539627,11702630,47084174,31298257
2021-07-01,955064,465871,489101,57176115,6622197,11829303,47550045,31804662
2021-07-02,825960,391114,434718,57810804,6716117,11904812,47941159,32255399
2021-07-03,379547,165650,213832,58066477,6795671,11932769,48106809,32474697
2021-07-04,255561,94219,161278,58233865,6863798,11944771,48201028,32636673
2021-07-05,529546,206660,322781,58616198,6957739,11982314,48407688,32970588
2021-07-06,844986,309172,535736,59299838,7056040,12029115,48716860,33517061
2021-07-07,1069247,360945,708134,60202844,7150818,12081937,49077805,34237051
2021-07-08,872362,290290,581974,60911211,7250989,12125383,49368095,34831312
2021-07-09,728154,224962,503024,61482541,7348669,12165830,49593057,35343778
2021-07-10,337447,105350,232015,61701858,7433712,12187346,49698407,35579506
2021-07-11,219249,67505,151648,61838657,7497600,12197308,49765912,35732112
2021-07-12,466110,161847,304161,62185787,7576488,12222489,49927759,36043998
2021-07-13,827583,210014,617481,62879942,7653188,12259415,50137773,36673617
2021-07-14,1058981,240618,818147,63793900,7724827,12308284,50378391,37505797
2021-07-15,784875,201097,583566,64445862,7795100,12347491,50579488,38103791
2021-07-16,641833,170921,470790,64973064,7859147,12376082,50750409,38586032
2021-07-17,279514,89698,186436,65155095,7922454,12391449,50840107,38774258
2021-07-18,179008,68499,110465,65271558,7964221,12401801,50908606,38885064
2021-07-19,369353,103178,266083,65559485,8014706,12419579,51011784,39157559
2021-07-20,659327,149631,509575,66135810,8062690,12441114,51161415,39673710
2021-07-21,812152,179423,632623,66864949,8108319,12464338,51340838,40313062
2021-07-22,657496,144380,513011,67444785,8151813,12484169,51485218,40833158
2021-07-23,538228,123280,414807,67908523,8193795,12499732,51608498,41253439
2021-07-24,209763,63259,146187,68060221,8232188,12507049,51671757,41401126
2021-07-25,111708,36787,74878,68131660,8263734,12509903,51708544,41476216
2021-07-26,333140,82008,251044,68401649,8302664,12522715,51790552,41730987
2021-07-27,599806,118239,481421,68924203,8344990,12544535,51908791,42216720
2021-07-28,742186,143945,597974,69580806,8391625,12569185,52052736,42819341
2021-07-29,591642,122654,468736,70094440,8435140,12589014,52175390,43292999
2021-07-30,474475,107406,366732,70492336,8480581,12604113,52282796,43663790
2021-07-31,190835,59527,131083,70628836,8516734,12609947,52342323,43795666
2021-08-01,105127,34809,70122,70701436,8541651,12611665,52377132,43865843
2021-08-02,290435,70497,219710,70938140,8575092,12620546,52447629,44088877
2021-08-03,500784,96698,403683,71375258,8613419,12632433,52544327,44497255
2021-08-04,614849,119863,494586,71927685,8650235,12644534,52664190,44996853
2021-08-05,533889,104843,428679,72399589,8690164,12651633,52769033,45430949
2021-08-06,427930,95139,332386,72769665,8725926,12658560,52864172,45767638
2021-08-07,181032,53636,126935,72904208,8757971,12659889,52917808,45894970
2021-08-08,109129,26673,82288,72987284,8779598,12660460,52944481,45977386
2021-08-09,292751,62189,230201,73223293,8821103,12666214,53006670,46210631
2021-08-10,468585,93510,374705,73629126,8863679,12674501,53100180,46589517
2021-08-11,577934,129121,448171,74133802,8911230,12683905,53229301,47042457
2021-08-12,487353,126688,360051,74555876,8949534,12691109,53355989,47408583
2021-08-13,403742,112725,290382,74893185,8990734,12696658,53468714,47703396
2021-08-14,195292,67899,126741,75038537,9023155,12697998,53536613,47830560
2021-08-15,111978,37399,74340,75122279,9044010,12698449,53574012,47904994
2021-08-16,264957,85424,178803,75336954,9076955,12701485,53659436,48087642
2021-08-17,396800,124492,271543,75681978,9106744,12707180,53783928,48364348
2021-08-18,456206,148077,307159,76082766,9136887,12713146,53932005,48677363
2021-08-19,377695,138706,237856,76408329,9163384,12718604,54070711,48921960
2021-08-20,309146,123644,184305,76669000,9187243,12722553,54194355,49111085
2021-08-21,153931,72746,80521,76786922,9208381,12723244,54267101,49192003
2021-08-22,90712,39084,51258,76856046,9223923,12723417,54306185,49243421
2021-08-23,224043,91582,131610,77033425,9253112,12726866,54397767,49379053
2021-08-24,320508,131913,187278,77307889,9278863,12730274,54529680,49572255
2021-08-25,363090,151501,209606,77623851,9303862,12733463,54681181,49787623
2021-08-26,311496,140734,168773,77891945,9325608,12736245,54821915,49963135
2021-08-27,263337,120864,140332,78111242,9347961,12738553,54942779,50108271
2021-08-28,138315,71007,66135,78218641,9363328,12739085,55013786,50174849
2021-08-29,80722,36006,43913,78284569,9371724,12739158,55049792,50218831
2021-08-30,187743,85885,100527,78439915,9388857,12740985,55135677,50323197
2021-08-31,273819,127077,144463,78680273,9404778,12743138,55262754,50473331
2021-09-01,326159,136160,166448,78973032,9420446,12745218,55398914,50645392
2021-09-02,277471,123126,135496,79220235,9433482,12747151,55522040,50787648
2021-09-03,223411,97731,109829,79415742,9445696,12748413,55619771,50901919
2021-09-04,106423,47863,53851,79503385,9454229,12748772,55667634,50956095
2021-09-05,59811,26431,30291,79552452,9459934,12748831,55694065,50986495
2021-09-06,153176,64710,72612,79685558,9469628,12749933,55758775,51062397
2021-09-07,246847,102554,118638,79910319,9478822,12751201,55861329,51186028
2021-09-08,284378,113882,138725,80168390,9491047,12752461,55975211,51329482
2021-09-09,269636,111812,129792,80411366,9502376,12753646,56087023,51465315
2021-09-10,218976,85255,111778,80601293,9514855,12754632,56172278,51581379
2021-09-11,108541,43269,59056,80689873,9523696,12754765,56215547,51640755
2021-09-12,61587,22775,34361,80741026,9528855,12754809,56238322,51675186
2021-09-13,160643,61800,78397,80878510,9539027,12755762,56300122,51757183
2021-09-14,265202,104190,123910,81120473,9547230,12757325,56404312,51886107
2021-09-15,311918,113805,148757,81404655,9558643,12758466,56518117,52040065
2021-09-16,290782,114045,136443,81668056,9568452,12760034,56632162,52182920
2021-09-17,236459,88497,117186,81877140,9579383,12760654,56720659,52304410
2021-09-18,111312,41378,62180,81970425,9587015,12760892,56762037,52366929
2021-09-19,62991,21710,36243,82022845,9592858,12761052,56783747,52403191
2021-09-20,158398,52668,80377,82162902,9600705,12761945,56836415,52486691
2021-09-21,263052,89607,125722,82406657,9608508,12762638,56926022,52617084
2021-09-22,300989,96077,143224,82684620,9618517,12763480,57022099,52764533
2021-09-23,284895,99331,135046,82947109,9626667,12764182,57121430,52905257
2021-09-24,222328,73633,113774,83146884,9636101,12764619,57195063,53022788
2021-09-25,99626,32404,57456,83231498,9642451,12764707,57227467,53080740
2021-09-26,53432,16865,31394,83276968,9646297,12764740,57244332,53112210
2021-09-27,148731,47158,73473,83410988,9652434,12765081,57291490,53188686
2021-09-28,251687,81977,117406,83646526,9658123,12765431,57373467,53310286
2021-09-29,268272,82426,125058,83898573,9663776,12765947,57455893,53439367
2021-09-30,233054,75189,113426,84115489,9669374,12766274,57531082,53556853
2021-10-01,127009,43958,57075,84232837,9672399,12766492,57575040,53617389
2021-10-02,29137,12197,13569,84256998,9674355,12766530,57587237,53631184
2021-10-03,8485,3252,3858,84263933,9675107,12766532,57590489,53635111
2021-10-04,96411,31737,43917,84351334,9678722,12766725,57622226,53682055
2021-10-05,220262,64843,101892,84561090,9682545,12767004,57687069,53787896
2021-10-06,233669,65616,104491,84783583,9686864,12767202,57752685,53896307
2021-10-07,237455,71269,110142,85008471,9691285,12767472,57823954,54011507
2021-10-08,158031,48475,69790,85155330,9695459,12767623,57872429,54085019
2021-10-09,37872,15257,17840,85187498,9697958,12767644,57887686,54103134
2021-10-10,11847,5071,5445,85197194,9698872,12767648,57892757,54108615
2021-10-11,98524,30849,42558,85287396,9702650,12767803,57923606,54153645
2021-10-12,214488,58557,93233,85491103,9707862,12768008,57982163,54250189
2021-10-13,231889,61721,97186,85711906,9713388,12768256,58043884,54350032
2021-10-14,230951,63490,100785,85931114,9718946,12768480,58107374,54454439
2021-10-15,151404,43069,65070,86072044,9724390,12768578,58150443,54521868
2021-10-16,39352,15114,18382,86106146,9726942,12768595,58165557,54540490
2021-10-17,11877,4442,5363,86115025,9729102,12768601,58169999,54545874
2021-10-18,99016,28034,40380,86206245,9733051,12768724,58198033,54588213
2021-10-19,212493,53356,88297,86409309,9738029,12768929,58251389,54678893
2021-10-20,229732,54358,89616,86629468,9743194,12769078,58305747,54770732
2021-10-21,224233,55741,89416,86844552,9747824,12769208,58361488,54862636
2021-10-22,151244,38643,58232,86986475,9752892,12769300,58400131,54922696
2021-10-23,39747,13940,15642,87020833,9755918,12769323,58414071,54938663
2021-10-24,11971,4033,4965,87031276,9756624,12769324,58418104,54943653
2021-10-25,108760,25724,40072,87133258,9760520,12769402,58443828,54985236
2021-10-26,252434,52135,91809,87375797,9766347,12769541,58495963,55079160
2021-10-27,275132,54432,91169,87639886,9773565,12769689,58550395,55172220
2021-10-28,275348,55644,92569,87904156,9780369,12769889,58606039,55267111
2021-10-29,186622,39861,58547,88079909,9787536,12770048,58645900,55327140
2021-10-30,47294,14538,15281,88121289,9791286,12770068,58660438,55342683
2021-10-31,12916,3980,4047,88132649,9792191,12770084,58664418,55346761
2021-11-01,61260,12046,16463,88189401,9795288,12770132,58676464,55363971
2021-11-02,250705,43320,72993,88430511,9802125,12770286,58719784,55438431
2021-11-03,325224,54028,80677,88743393,9810869,12770445,58773812,55520720
2021-11-04,331816,58424,84816,89062749,9819065,12770685,58832236,55607647
2021-11-05,243909,43227,53830,89293515,9827983,12770756,58875463,55663181
2021-11-06,70425,18986,16052,89355206,9833686,12770786,58894449,55679649
2021-11-07,23614,5986,5395,89375894,9835682,12770787,58900435,55685084
2021-11-08,179551,31157,36009,89544361,9843290,12770869,58931592,55722673
2021-11-09,393980,61556,79804,89922326,9854417,12771029,58993148,55804719
2021-11-10,450079,65747,79285,90355467,9866591,12771160,59058895,55885968
2021-11-11,452426,70076,81585,90789785,9879497,12771283,59128971,55970248
2021-11-12,352915,54758,53202,91125084,9892179,12771368,59183729,56025662
2021-11-13,105834,26091,17296,91221965,9897974,12771382,59209820,56043519
2021-11-14,33223,7969,4680,91252073,9900299,12771389,59217789,56048239
2021-11-15,253012,39876,35014,91491239,9910181,12771585,59257665,56085183
2021-11-16,535054,72600,73327,92007395,9924324,12771716,59330265,56161018
2021-11-17,599396,75175,71075,92584566,9941677,12771817,59405440,56234199
2021-11-18,638299,82635,77511,93197684,9960759,12771986,59488075,56314885
2021-11-19,535872,72709,54891,93706214,9980884,12772443,59560784,56372327
2021-11-20,241465,48919,20824,93926042,9995462,12772518,59609703,56393971
2021-11-21,79787,14541,6485,93994851,10004606,12772540,59624244,56400676
2021-11-22,427935,68297,35142,94390650,10028871,12772629,59692541,56439482
2021-11-23,857777,125755,75225,95195625,10069235,12772867,59818296,56520663
2021-11-24,1019604,144209,83194,96146269,10124190,12773092,59962505,56609399
2021-11-25,964224,145472,84124,97036840,10183032,12773569,60107977,56701278
2021-11-26,840374,116977,62285,97796825,10251462,12773754,60224954,56768982
2021-11-27,704877,110235,36947,98399125,10340837,12773838,60335189,56808936
2021-11-28,172224,26632,9381,98525855,10382912,12773850,60361821,56818671
2021-11-29,590379,83533,42001,98994332,10495779,12774041,60445354,56865850
2021-11-30,1049140,122851,79315,99743640,10785362,12774348,60568205,56951336
2021-12-01,1275390,125729,85359,100577823,11217514,12774587,60693934,57041550
2021-12-02,1189177,117137,88912,101338576,11636254,12774964,60811071,57136181
2021-12-03,1077207,97742,67687,102006160,12038568,12775066,60908813,57207983
2021-12-04,1018373,87518,43133,102505025,12549696,12775393,60996331,57253505
2021-12-05,273542,21362,12346,102616533,12710099,12775401,61017693,57266407
2021-12-06,752192,68196,47664,103014439,13057569,12775684,61085889,57317903
2021-12-07,1203519,94545,83437,103662323,13606416,12775831,61180434,57405903
2021-12-08,1424379,101380,90580,104395739,14291174,12776011,61281814,57500251
2021-12-09,1322402,93879,94599,105082831,14920298,12776219,61375693,57598759
2021-12-10,1222987,78681,79933,105698735,15521880,12776428,61454374,57681895
2021-12-11,1217571,73119,55860,106192054,16241777,12776471,61527493,57739165
2021-12-12,317441,17837,16748,106307050,16443049,12776482,61545330,57756207
2021-12-13,807220,54270,59853,106703954,16849496,12776578,61599600,57818454
2021-12-14,1350867,87796,110876,107447564,17452399,12776757,61687396,57931814
2021-12-15,1561199,104580,124124,108311482,18145987,12776884,61791976,58058123
2021-12-16,1461929,104669,136132,109134000,18781461,12777241,61896645,58196566
2021-12-17,1278069,105717,113891,109848014,19342322,12777367,62002362,58312248
2021-12-18,1137341,107679,77775,110405302,19920043,12777608,62110041,58390868
2021-12-19,349462,42159,22165,110571523,20102392,12777878,62152200,58413222
2021-12-20,893828,75270,89492,111059682,20505902,12777953,62227470,58503971
2021-12-21,1240915,99748,135755,111770504,21033590,12778181,62327218,58641119
2021-12-22,1218392,100900,125683,112462922,21557598,12778388,62428118,58767867
2021-12-23,670722,59392,73454,112832799,21857067,12778515,62487510,58841980
2021-12-24,48817,4010,5230,112857225,21881330,12778527,62491520,58847266
2021-12-25,27978,1647,1963,112871209,21895125,12778633,62493167,58849256
2021-12-26,62495,5299,4776,112902647,21926102,12778634,62498466,58854063
2021-12-27,605813,50648,64068,113206769,22226714,12778793,62549114,58918651
2021-12-28,748297,64540,80240,113594307,22586322,12778936,62613654,58999291
2021-12-29,699804,64781,72547,113959465,22919746,12779268,62678435,59072195
2021-12-30,486248,46654,52224,114204337,23160039,12779302,62725089,59124698
2021-12-31,59490,4773,6045,114231165,23192523,12779365,62729862,59130784
2022-01-01,28687,2217,2904,114244357,23207932,12779420,62732079,59133688
2022-01-02,154132,16420,14293,114326429,23279843,12779426,62748499,59148008
2022-01-03,481535,39478,61906,114577583,23509492,12779460,62787977,59210232
2022-01-04,700953,57441,95581,114964922,23821349,12780104,62845418,59306544
2022-01-05,816798,60367,112987,115423804,24178111,12780342,62905785,59420031
2022-01-06,683718,51479,92297,115814320,24469898,12780917,62957264,59512844
2022-01-07,765902,56740,117272,116260711,24787395,12781018,63014004,59631086
2022-01-08,519209,45727,82685,116560516,25005826,12781126,63059731,59713982
2022-01-09,185153,18711,34735,116675582,25075369,12781422,63078442,59748817
2022-01-10,559347,37363,84393,116992871,25316379,12781433,63115805,59833706
2022-01-11,796401,54356,120416,117456348,25647094,12781882,63170161,59954958
2022-01-12,880891,59795,134444,117978382,26004286,12781974,63229956,60089882
2022-01-13,837024,58303,126271,118480216,26337465,12782214,63288259,60216757
2022-01-14,778763,62473,114554,118954403,26639227,12782850,63350732,60331847
2022-01-15,466340,58709,71359,119244907,26814213,12783077,63409441,60403297
2022-01-16,154496,18906,23308,119343113,26870064,12783150,63428347,60426812
2022-01-17,480613,39577,74094,119640101,27052650,12783210,63467924,60501269
2022-01-18,652207,50668,97557,120055605,27287748,12783597,63518592,60599456
2022-01-19,680727,58593,105911,120495576,27525730,12784884,63577185,60705993
2022-01-20,701223,57805,107163,120950781,27770738,12784955,63634990,60813446
2022-01-21,596948,53349,94668,121346670,27970737,12785003,63688339,60908475
2022-01-22,295946,38307,57637,121545127,28067512,12785078,63726646,60966237
2022-01-23,107724,13271,26584,121619880,28100400,12785080,63739917,60992843
2022-01-24,356700,31069,64967,121855219,28221249,12785083,63770986,61058008
2022-01-25,499985,41495,86071,122198989,28375762,12785486,63812481,61144637
2022-01-26,503470,41490,84801,122553455,28523882,12785521,63853971,61229664
2022-01-27,509722,41803,95972,122915990,28668169,12785584,63895774,61325636
2022-01-28,437258,38527,81818,123235028,28785641,12785611,63934301,61407454
2022-01-29,211305,26470,53643,123390725,28840849,12785768,63960771,61461097
2022-01-30,75557,8909,20966,123446790,28860216,12785790,63969680,61482063
2022-01-31,232371,21547,47905,123617856,28920868,12785853,63991227,61529968
2022-02-01,292713,25546,56993,123841564,28989475,12785877,64016773,61586961
2022-02-02,361253,30625,69360,124121136,29069890,12786286,64047398,61656321
2022-02-03,341906,28731,67260,124392081,29140296,12786291,64076129,61723581
2022-02-04,312233,26118,69113,124637928,29205986,12786519,64102247,61792694
2022-02-05,147757,16358,51951,124756255,29235195,12786526,64118605,61844645
2022-02-06,53016,5576,18388,124799445,29244907,12786545,64124181,61863033
2022-02-07,167527,12818,39728,124931258,29280320,12786558,64136999,61902761
2022-02-08,276490,21542,59119,125152098,29334937,12786956,64158541,61961880
2022-02-09,282776,19972,60043,125379785,29389566,12786973,64178513,62021923
2022-02-10,277180,18784,58735,125605295,29440568,12786978,64197297,62080658
2022-02-11,250319,17482,58059,125809318,29486323,12786996,64214779,62138717
2022-02-12,110376,10504,37409,125899821,29505985,12787011,64225283,62176126
2022-02-13,34507,3027,11485,125927750,29512475,12787017,64228310,62187611
2022-02-14,133899,9542,29857,126036261,29537573,12787047,64237852,62217468
2022-02-15,223755,14401,46495,126217858,29578946,12787446,64252253,62263963
2022-02-16,224652,13035,43689,126404521,29616529,12787465,64265288,62307652
2022-02-17,228411,12827,45929,126594986,29654111,12787483,64278115,62353581
2022-02-18,210595,16202,47903,126771836,29687436,12787563,64294317,62401484
2022-02-19,81109,6711,27810,126840217,29700037,12787565,64301028,62429294
2022-02-20,30948,2385,9432,126865103,29706045,12787575,64303413,62438726
2022-02-21,132393,10284,28405,126974228,29729070,12787615,64313697,62467131
2022-02-22,203543,11689,38519,127145372,29760469,12788068,64325386,62505650
2022-02-23,207606,10773,36332,127319070,29793600,12788493,64336159,62541982
2022-02-24,210521,11397,38238,127495955,29826839,12788575,64347556,62580220
2022-02-25,175787,9516,33929,127643518,29854420,12788804,64357072,62614149
2022-02-26,61906,4986,18399,127694856,29864341,12788817,64362058,62632548
2022-02-27,19322,2358,5006,127710060,29867242,12788826,64364416,62637554
2022-02-28,103322,8794,18218,127790435,29886316,12788828,64373210,62655772
2022-03-01,162492,10107,24424,127923131,29911950,12788866,64383317,62680196
2022-03-02,160769,10933,24054,128053805,29937632,12788926,64394250,62704250
2022-03-03,216294,11365,29766,128229437,29974010,12788935,64405615,62734016
2022-03-04,162965,11360,25039,128359598,30001500,12788966,64416975,62759055
2022-03-05,54972,6409,11590,128400238,30011717,12788975,64423384,62770645
2022-03-06,22470,4299,4289,128415740,30015229,12788976,64427683,62774934
2022-03-07,95199,7986,13879,128491377,30030937,12789018,64435669,62788813
2022-03-08,168954,9198,20897,128628832,30058537,12789481,64444867,62809710
2022-03-09,178361,8191,19131,128773712,30088933,12789598,64453058,62828841
2022-03-10,194816,8562,20899,128931828,30123360,12789611,64461620,62849740
2022-03-11,167548,9483,20522,129066359,30153040,12790122,64471103,62870262
2022-03-12,52224,4495,8989,129106109,30163406,12790128,64475598,62879251
2022-03-13,18501,1645,2932,129119605,30168000,12790128,64477243,62882183
2022-03-14,92326,4910,9312,129193589,30185113,12790134,64482153,62891495
2022-03-15,174206,7269,15973,129335568,30215377,12790509,64489422,62907468
2022-03-16,183324,6541,13875,129483477,30249205,12790517,64495963,62921343
2022-03-17,194383,6418,14635,129640860,30284926,12790545,64502381,62935978
2022-03-18,149367,6447,13373,129762153,30311472,12790560,64508828,62949351
2022-03-19,48023,3462,6467,129799016,30321101,12790565,64512290,62955818
2022-03-20,17062,1803,3099,129812032,30324386,12790565,64514093,62958917
2022-03-21,94674,4010,8764,129887455,30341311,12790574,64518103,62967681
2022-03-22,167881,6998,14063,130023151,30369889,12790954,64525101,62981744
2022-03-23,178842,5830,13411,130167734,30400291,12790961,64530931,62995155
2022-03-24,183886,6026,13480,130317239,30431338,12790963,64536957,63008635
2022-03-25,152206,5338,13350,130439560,30456903,12791000,64542295,63021985
2022-03-26,42886,2845,6866,130470940,30465354,12791031,64545140,63028851
2022-03-27,16168,928,2747,130482424,30468587,12791031,64546068,63031598
2022-03-28,93652,3341,8454,130555435,30485833,12791132,64549409,63040052
2022-03-29,165878,5610,11377,130690198,30513561,12791533,64555019,63051429
2022-03-30,186840,5091,10992,130841292,30546481,12791596,64560110,63062421
2022-03-31,181590,5826,12558,130987947,30578959,12791641,64565936,63074979
2022-04-01,119859,4017,9144,131085397,30599177,12791641,64569953,63084123
2022-04-02,34906,2034,4158,131111624,30606133,12791672,64571987,63088281
2022-04-03,13818,961,1510,131122314,30608832,12791672,64572948,63089791
2022-04-04,74938,2269,4945,131182493,30622392,12791674,64575217,63094736
2022-04-05,152328,4206,8618,131309611,30645834,12792055,64579423,63103354
2022-04-06,182970,5641,12041,131460175,30676603,12792055,64585064,63115395
2022-04-07,183122,3898,8926,131613445,30705104,12792055,64588962,63124321
2022-04-08,142080,3621,8357,131730795,30727674,12792095,64592583,63132678
2022-04-09,33445,1567,3842,131755484,30735179,12792095,64594150,63136520
2022-04-10,11203,548,1236,131764567,30737009,12792095,64594698,63137756
2022-04-11,63882,1930,4281,131816818,30747648,12792142,64596628,63142037
2022-04-12,119318,2542,5637,131917633,30765044,12792175,64599170,63147674
2022-04-13,126551,4358,5579,132024221,30783709,12792195,64603528,63153253
2022-04-14,105452,2723,6015,132112470,30799607,12792311,64606251,63159268
2022-04-15,6337,311,624,132117394,30800868,12792311,64606562,63159892
2022-04-16,7139,485,1089,132122832,30802196,12792311,64607047,63160981
2022-04-17,1956,223,285,132124243,30802678,12792311,64607270,63161266
2022-04-18,2800,173,361,132126278,30803349,12792311,64607443,63161627
2022-04-19,75051,4503,4779,132189363,30814177,12792321,64611946,63166406
2022-04-20,92235,2101,4940,132267023,30827629,12792338,64614047,63171346
2022-04-21,104130,2126,5576,132355228,30842570,12792340,64616173,63176922
2022-04-22,85086,2417,6192,132425282,30856441,12792352,64618590,63183114
2022-04-23,20356,1158,2868,132440175,30861122,12792368,64619748,63185982
2022-04-24,6550,376,794,132445226,30862411,12792371,64620124,63186776
2022-04-25,53969,1945,4180,132490943,30869951,12792375,64622069,63190956
2022-04-26,116909,4993,8442,132589422,30886101,12792996,64627062,63199398
2022-04-27,119722,2556,6036,132691984,30902274,12793001,64629618,63205434
2022-04-28,122486,2546,6248,132796727,30919123,12793003,64632164,63211682
2022-04-29,103300,7560,10403,132884511,30932371,12794249,64639724,63222085
2022-04-30,21185,1165,2823,132900835,30936511,12794255,64640889,63224908
2022-05-01,4387,258,346,132904289,30937333,12794255,64641147,63225254
2022-05-02,42922,1375,2639,132940267,30943780,12794277,64642522,63227893
2022-05-03,91625,2952,5984,133019297,30955236,12794650,64645474,63233877
2022-05-04,148100,2563,5830,133145771,30976142,12794655,64648037,63239707
2022-05-05,105635,3084,6029,133237532,30988915,12794951,64651121,63245736
2022-05-06,76693,1960,4091,133304277,30998129,12794958,64653081,63249827
2022-05-07,15336,844,1764,133316529,31000919,12794961,64653925,63251591
2022-05-08,4348,204,452,133320307,31001448,12794961,64654129,63252043
2022-05-09,35768,1034,2108,133350642,31006563,12794961,64655163,63254151
2022-05-10,82638,2371,4369,133422359,31016515,12795336,64657534,63258520
2022-05-11,83397,1791,3450,133495686,31026018,12795337,64659325,63261970
2022-05-12,86218,1890,3745,133571576,31035707,12795337,64661215,63265715
2022-05-13,59621,1456,3301,133623208,31043266,12795340,64662671,63269016
2022-05-14,11667,655,1423,133632574,31045251,12795340,64663326,63270439
2022-05-15,4142,263,523,133635789,31046066,12795340,64663589,63270962
2022-05-16,30984,964,1976,133662466,31050040,12795360,64664553,63272938
2022-05-17,69598,2271,4141,133723361,31057801,12795742,64666824,63277079
2022-05-18,68413,1344,3146,133784382,31064768,12795743,64668168,63280225
2022-05-19,74951,1702,3774,133850521,31073160,12795743,64669870,63283999
2022-05-20,55314,1386,3126,133898239,31080255,12795751,64671256,63287125
2022-05-21,11745,700,1524,133907756,31082082,12795765,64671956,63288649
2022-05-22,3585,171,393,133910788,31082553,12795766,64672127,63289042
2022-05-23,28923,895,1962,133935693,31086242,12795767,64673022,63291004
2022-05-24,63194,2369,4286,133991262,31092925,12796154,64675391,63295290
2022-05-25,61033,1859,3392,134045134,31099604,12796155,64677250,63298682
2022-05-26,2493,181,228,134047107,31100029,12796155,64677431,63298910
2022-05-27,20847,950,1843,134064631,31102976,12796155,64678381,63300753
2022-05-28,7771,647,1008,134070819,31104307,12796155,64679028,63301761
2022-05-29,2618,230,343,134072892,31104743,12796155,64679258,63302104
2022-05-30,25015,883,1798,134094597,31107734,12796155,64680141,63303902
2022-05-31,48769,1511,3004,134137485,31113144,12796160,64681652,63306906
2022-06-01,49776,1306,2610,134181979,31118065,12796166,64682958,63309516
2022-06-02,56767,1466,3317,134232444,31123996,12796172,64684424,63312833
2022-06-03,42858,1529,2772,134270072,31128808,12796178,64685953,63315605
2022-06-04,7755,509,813,134276359,31130076,12796180,64686462,63316418
2022-06-05,1612,57,141,134277769,31130248,12796180,64686519,63316559
2022-06-06,1806,60,142,134279348,31130457,12796180,64686579,63316701
2022-06-07,33494,1157,2265,134308556,31134194,12796384,64687736,63318966
2022-06-08,42545,1225,2248,134345674,31139277,12796384,64688961,63321214
2022-06-09,51891,1530,2975,134391898,31144506,12796384,64690491,63324189
2022-06-10,37776,1317,2548,134424501,31149304,12796387,64691808,63326737
2022-06-11,9634,747,986,134432114,31151080,12796387,64692555,63327723
2022-06-12,2373,208,319,134433972,31151534,12796387,64692763,63328042
2022-06-13,23137,848,1589,134454086,31154285,12796389,64693611,63329631
2022-06-14,45790,1344,2514,134494563,31159205,12796391,64694955,63332145
2022-06-15,48106,1907,2545,134536319,31165167,12796391,64696862,63334690
2022-06-16,27096,997,1861,134558798,31169628,12796391,64697859,63336551
2022-06-17,33571,1104,1957,134585792,31175858,12796391,64698963,63338508
2022-06-18,9815,597,790,134593219,31178047,12796391,64699560,63339298
2022-06-19,4438,338,448,134596537,31178986,12796425,64699898,63339746
2022-06-20,25645,927,1367,134618232,31182689,12796427,64700825,63341113
2022-06-21,49736,1327,2416,134661736,31188513,12796428,64702152,63343529
2022-06-22,54802,1305,2239,134708593,31196008,12796429,64703457,63345768
2022-06-23,64254,1508,2554,134764763,31203777,12796435,64704965,63348322
2022-06-24,48577,1721,2658,134805776,31210902,12796435,64706686,63350980
2022-06-25,12213,717,972,134815240,31213424,12796436,64707403,63351952
2022-06-26,3258,253,367,134817896,31213935,12796436,64707656,63352319
2022-06-27,24471,820,1246,134838804,31217286,12796437,64708476,63353565
2022-06-28,55719,2420,2985,134888290,31222847,12796464,64710896,63356550
2022-06-29,54456,1426,2199,134935903,31229336,12796477,64712322,63358749
2022-06-30,61209,1604,2873,134990502,31235615,12796479,64713926,63361622
2022-07-01,35654,1323,1934,135021029,31240397,12796479,64715249,63363556
2022-07-02,10439,512,893,135029375,31242348,12796497,64715761,63364449
2022-07-03,2696,104,205,135031610,31242767,12796497,64715865,63364654
2022-07-04,21021,619,972,135049660,31245620,12796501,64716484,63365626
2022-07-05,47600,1151,1788,135091952,31250704,12796502,64717635,63367414
2022-07-06,52369,1287,2027,135138014,31256725,12796503,64718922,63369441
2022-07-07,60291,1547,2951,135191221,31263443,12796516,64720469,63372392
2022-07-08,42398,1331,1954,135227583,31269126,12796516,64721800,63374346
2022-07-09,11551,601,775,135236622,31271476,12796516,64722401,63375121
2022-07-10,2693,82,159,135238781,31271952,12796519,64722483,63375280
2022-07-11,25050,970,1595,135259831,31275344,12796527,64723453,63376875
2022-07-12,57171,1464,2224,135309921,31282082,12796527,64724917,63379099
2022-07-13,59744,1181,1957,135361559,31289984,12796530,64726098,63381056
2022-07-14,65461,1156,1903,135418424,31298363,12796532,64727254,63382959
2022-07-15,54434,1377,2139,135462716,31308186,12796533,64728631,63385098
2022-07-16,16345,669,797,135474947,31312093,12796548,64729300,63385895
2022-07-17,3891,158,213,135477982,31312876,12796548,64729458,63386108
2022-07-18,26140,676,933,135499825,31316995,12796572,64730134,63387041
2022-07-19,52154,1019,1586,135545913,31322807,12796572,64731153,63388627
2022-07-20,50734,971,1495,135590544,31328706,12796572,64732124,63390122
2022-07-21,63852,1247,1790,135646296,31336493,12796572,64733371,63391912
2022-07-22,48904,2041,2154,135687661,31343288,12796572,64735412,63394066
2022-07-23,11027,547,678,135696113,31345676,12796572,64735959,63394744
2022-07-24,4243,371,515,135699663,31346276,12796572,64736330,63395259
2022-07-25,22151,570,891,135718942,31349017,12796582,64736900,63396150
2022-07-26,51316,1125,1679,135764479,31354530,12796583,64738025,63397829
2022-07-27,52809,1052,1547,135811149,31360408,12796584,64739077,63399376
2022-07-28,54980,966,1557,135860306,31365979,12796584,64740043,63400933
2022-07-29,41701,1317,1477,135896559,31370947,12796596,64741360,63402410
2022-07-30,9529,472,708,135904019,31372859,12796596,64741832,63403118
2022-07-31,2800,124,146,135906104,31373471,12796597,64741956,63403264
2022-08-01,19354,813,985,135922492,31376160,12796719,64742769,63404249
2022-08-02,38176,767,1180,135956347,31380250,12796719,64743536,63405429
2022-08-03,41517,905,1472,135993313,31384577,12796728,64744441,63406901
2022-08-04,42485,878,1282,136031773,31388372,12796728,64745319,63408183
2022-08-05,32444,936,1279,136059900,31392453,12796729,64746255,63409462
2022-08-06,9203,451,645,136067006,31394374,12796729,64746706,63410107
2022-08-07,2082,102,134,136068769,31394644,12796729,64746808,63410241
2022-08-08,17148,534,708,136083525,31396852,12796731,64747342,63410949
2022-08-09,37936,802,1292,136117342,31400814,12796731,64748144,63412241
2022-08-10,39216,856,1415,136152557,31404643,12796731,64749000,63413656
2022-08-11,40496,879,1416,136188917,31408566,12796731,64749879,63415072
2022-08-12,28722,874,1215,136214169,31411805,12796731,64750753,63416287
2022-08-13,5900,358,496,136218681,31413005,12796736,64751111,63416783
2022-08-14,1955,115,145,136220313,31413215,12796736,64751226,63416928
2022-08-15,13529,484,692,136231826,31415044,12796744,64751710,63417620
2022-08-16,32505,819,1288,136261028,31418125,12796745,64752529,63418908
2022-08-17,35296,1086,1481,136293123,31421062,12796750,64753615,63420389
2022-08-18,42275,3858,3626,136331652,31424414,12796831,64757473,63424015
2022-08-19,29213,945,1406,136356677,31428327,12796832,64758418,63425421
2022-08-20,7090,299,507,136362304,31429652,12796835,64758717,63425928
2022-08-21,2301,97,163,136364106,31430082,12796835,64758814,63426091
2022-08-22,16846,566,789,136378341,31432525,12796838,64759380,63426880
2022-08-23,34825,834,1253,136409397,31436128,12796838,64760214,63428133
2022-08-24,38112,914,1319,136443568,31439810,12796838,64761128,63429452
2022-08-25,37862,759,1227,136477420,31443580,12796839,64761887,63430679
2022-08-26,28838,802,1321,136502441,31447129,12796840,64762689,63432000
2022-08-27,6724,339,466,136507346,31448775,12796840,64763028,63432466
2022-08-28,1814,101,106,136508770,31449127,12796840,64763129,63432572
2022-08-29,16731,544,768,136523271,31451147,12796848,64763673,63433340
2022-08-30,33143,759,1215,136553183,31454181,12796848,64764432,63434555
2022-08-31,36107,916,1339,136585733,31457494,12796848,64765348,63435894
2022-09-01,31924,773,1083,136614956,31459969,12796848,64766121,63436977
2022-09-02,27146,941,1196,136639120,31462742,12796849,64767062,63438173
2022-09-03,5879,359,550,136643972,31463602,12796849,64767421,63438723
2022-09-04,1751,80,100,136645527,31463762,12796849,64767501,63438823
2022-09-05,13502,590,680,136657495,31465150,12796850,64768091,63439503
2022-09-06,27424,821,1155,136682675,31467209,12796850,64768912,63440658
2022-09-07,27963,726,1066,136708241,31469383,12796850,64769638,63441724
2022-09-08,28068,755,1083,136733879,31471578,12796852,64770393,63442807
2022-09-09,18882,733,920,136750751,31473301,12796852,64771126,63443727
